Name, Team, Matches, Innings, Ground, Country, Dismissals, Caught, Stumped, Caught by Keeper, Caught by Fielder, Best Dismissals, Best Caught Fielder, Best Caught Keeper, Best Stumpings
D Ripley, Marylebone Cricket Club; Northamptonshire, 134, 243, , , 356, 321, 35, 317, 4, 6, 0, 6, 0
KV Andrew, North; Players; Marylebone Cricket Club; England; England XI; Combined Services; AER Gilligan's XI; Northamptonshire; TN Pearce's XI; Commonwealth XI, 137, 256, , , 327, 257, 70, 257, 0, 5, 0, 5, 0
G Sharp, TN Pearce's XI; Northamptonshire, 141, 257, , , 294, 248, 46, 248, 0, 5, 0, 5, 0
BW Bellamy, Northamptonshire, 143, 240, , , 272, 225, 47, 222, 3, 5, 0, 5, 0
WA Buswell, Northamptonshire, 103, 180, , , 213, 146, 67, 145, 1, 4, 0, 3, 1
DS Steele, DH Robins' XI; Leicestershire; Northamptonshire; TN Pearce's XI; Derbyshire; England; Marylebone Cricket Club, 186, 338, , , 210, 210, 0, 0, 210, 4, 4, 0, 0
G Cook, Northamptonshire; TN Pearce's XI; Eastern Province; Marylebone Cricket Club; England; England XI, 185, 336, , , 157, 155, 2, 3, 152, 4, 4, 0, 0
BL Reynolds, Players; AER Gilligan's XI; Northamptonshire, 164, 299, , , 142, 135, 7, 24, 111, 3, 0, 3, 0
LA Johnson, Marylebone Cricket Club; Northamptonshire, 62, 111, , , 125, 99, 26, 99, 0, 4, 0, 4, 0
RJ Bailey, Northamptonshire; Derbyshire; England XI; England; Marylebone Cricket Club; Test and County Cricket Board XI, 151, 273, , , 123, 123, 0, 0, 123, 5, 5, 0, 0
D Murphy, Loughborough Marylebone Cricket Club University; Loughborough University Centre of Cricketing Excellence; Scotland; Northamptonshire, 36, 61, , , 114, 107, 7, 107, 0, 5, 0, 5, 0
PJ Watts, Marylebone Cricket Club; Northamptonshire, 154, 284, , , 112, 112, 0, 0, 112, 4, 4, 0, 0
NJ O'Brien, North West Warriors; Marylebone Cricket Club; Kent; Ireland; Leicestershire; Northamptonshire, 32, 61, , , 106, 98, 8, 96, 2, 5, 0, 5, 0
K Fiddling, Northamptonshire; Yorkshire, 54, 99, , , 103, 84, 19, 84, 0, 4, 0, 4, 0
GJ Thompson, England; Marylebone Cricket Club; The Rest; Players; South; North; Under 30; Auckland; England XI; Lord Hawke's XI; Lord Londesborough's XI; CI Thornton's XI; Marylebone Cricket Club South African Touring Team; Northamptonshire; Lord Brackley's XI, 108, 188, , , 103, 103, 0, 0, 103, 3, 3, 0, 0
AM Rossington, Northamptonshire; Middlesex, 42, 72, , , 102, 97, 5, 94, 3, 5, 0, 5, 0
DJG Sales, Northamptonshire; Marylebone Cricket Club; Wellington; England A; First-Class Counties Select XI, 118, 212, , , 95, 95, 0, 0, 95, 4, 4, 0, 0
W Larkins, Northamptonshire; TN Pearce's XI; Eastern Province; England XI; Marylebone Cricket Club; England; DH Robins' XI; Young England; South African Breweries English XI; Test and County Cricket Board XI; DB Close's XI; Cricket Association of Bengal Overseas XI; Durham; Scarborough Festival President's XI, 166, 298, , , 90, 90, 0, 0, 90, 3, 3, 0, 0
AJ Lamb, Northamptonshire; Orange Free State; Western Province; England; Marylebone Cricket Club; England XI, 122, 221, , , 80, 80, 0, 0, 80, 2, 2, 0, 0
A Lightfoot, Players; TN Pearce's XI; AER Gilligan's XI; Combined Services; Northamptonshire, 120, 222, , , 78, 78, 0, 0, 78, 3, 3, 0, 0
MH Wessels, Mid West Rhinos; Worcestershire; Northamptonshire; Marylebone Cricket Club; Nottinghamshire; Nondescripts Cricket Club, 37, 65, , , 76, 67, 9, 43, 24, 4, 0, 4, 0
C Milburn, DH Robins' XI; Marylebone Cricket Club President's XI; Young England; Northamptonshire; TN Pearce's XI; Western Australia; Western Australia Combined XI; Marylebone Cricket Club; England XI; The Rest; England, 89, 163, , , 75, 75, 0, 0, 75, 3, 3, 0, 0
Mushtaq Mohammad, Marylebone Cricket Club; Karachi Blues; Karachi C; Karachi Whites; Karachi A; Karachi; President's XI; Peshawar; Pakistan International Airlines; BCCP XI; International Cavaliers; Pakistan Eaglets; Fazal Mahmood's XI; International XI; Pakistan Under-25s; Pakistan International Airlines A; DH Robins' XI; Rest of the World XI; Pakistan Banks; DB Close's XI; ZA Bhutto's XI; Pakistan; AER Gilligan's XI; TN Pearce's XI; Commonwealth XI; Pakistanis; The Rest; Northamptonshire, 115, 211, , , 74, 74, 0, 0, 74, 3, 3, 0, 0
GE Tribe, North; Victoria; The Rest; Australia; Players; Duke of Norfolk's XI; CG Howard's XI; LEG Ames' XI; Northamptonshire; AER Gilligan's XI; TN Pearce's XI; Commonwealth XI, 86, 154, , , 71, 71, 0, 0, 71, 3, 3, 0, 0
AH Bakewell, Northamptonshire; HDG Leveson-Gower's XI; North; The Rest; Players; Marylebone Cricket Club; England, 81, 133, , , 70, 70, 0, 0, 70, 3, 3, 0, 0
PD Watts, Northamptonshire; Nottinghamshire; Marylebone Cricket Club, 66, 127, , , 70, 70, 0, 0, 70, 4, 4, 0, 0
D Brookes, The Rest; England XI; South; North; Players; Marylebone Cricket Club; England; Northamptonshire; HDG Leveson-Gower's XI; Royal Air Force; Under 33, 182, 325, , , 66, 66, 0, 0, 66, 2, 2, 0, 0
KC James, Wellington; Northamptonshire; New Zealanders; New Zealand Services; New Zealand; Sir L Parkinson's XI, 34, 57, , , 65, 50, 15, 50, 0, 4, 0, 4, 0
FI Walden, Northamptonshire, 118, 207, , , 63, 63, 0, 0, 63, 3, 3, 0, 0
MHJ Allen, TN Pearce's XI; Northamptonshire; Derbyshire; Players; Marylebone Cricket Club; North, 59, 111, , , 62, 62, 0, 0, 62, 4, 4, 0, 0
DJ Capel, Northamptonshire; Eastern Province; Test and County Cricket Board XI; Eastern Province B; England A; England; Marylebone Cricket Club; England XI, 124, 225, , , 62, 62, 0, 0, 62, 3, 3, 0, 0
JV Murdin, Players; Northamptonshire, 79, 135, , , 62, 62, 0, 0, 62, 2, 2, 0, 0
P Willey, Leicestershire; Northamptonshire; TN Pearce's XI; Eastern Province; Marylebone Cricket Club; England XI; England; DH Robins' XI; England Under-25s; South African Breweries English XI, 150, 273, , , 61, 61, 0, 0, 61, 2, 2, 0, 0
BS Crump, AER Gilligan's XI; Northamptonshire; Marylebone Cricket Club; Players, 131, 241, , , 60, 60, 0, 0, 60, 2, 2, 0, 0
AJ Hall, Transvaal; South Africa; Northamptonshire; Worcestershire; South Africans; Dolphins; Lions; Mashonaland Eagles; Kent; South Africa A; Easterns; Transvaal B; South Africa Academy; Gauteng, 50, 90, , , 57, 57, 0, 0, 57, 3, 3, 0, 0
RM Prideaux, South; Marylebone Cricket Club; Kent; Gentlemen; Cambridge University; Sussex; England; Gentlemen of England; The Rest; England XI; DH Robins' XI; Young England; Orange Free State; Northamptonshire; TN Pearce's XI; Commonwealth XI, 102, 184, , , 57, 57, 0, 0, 57, 3, 3, 0, 0
GAT Vials, Northamptonshire, 63, 110, , , 56, 56, 0, 0, 56, 4, 4, 0, 0
RT Virgin, International XI; Marylebone Cricket Club; Somerset; TN Pearce's XI; Combined Services; Western Province; Northamptonshire, 57, 107, , , 55, 55, 0, 0, 55, 3, 3, 0, 0
RJ Warren, Northamptonshire; Nottinghamshire; The Rest, 55, 102, , , 55, 55, 0, 23, 32, 4, 4, 0, 0
TMB Bailey, British Universities; Northamptonshire, 26, 45, , , 54, 42, 12, 41, 1, 3, 0, 3, 0
AL Penberthy, Northamptonshire, 89, 163, , , 54, 54, 0, 0, 54, 2, 2, 0, 0
CN Woolley, Northamptonshire; North; Players; Gloucestershire, 162, 282, , , 54, 54, 0, 0, 54, 3, 3, 0, 0
JE Timms, Northamptonshire; North; The Rest, 171, 288, , , 53, 53, 0, 0, 53, 2, 2, 0, 0
H Elliott, Derbyshire; England; Marylebone Cricket Club; Marylebone Cricket Club South African Touring Team, 20, 39, , , 52, 42, 10, 42, 0, 4, 0, 3, 1
W Wells, Northamptonshire, 127, 222, , , 51, 51, 0, 0, 51, 3, 3, 0, 0
